##########+#########
#                  #
#         #        #
###  O  ###        #
#        ####     ##
#   X     #    @   #
####################